Acaron	NOM	Acaron
Escalon	NPR	Escalon
Grans	NPR	Grans
Grant	NPR	Grant_C
Lanceloht	NPR	Lanceloht
Lancelot	VER	Lancelot
Or	NPR	Or
Tenebreus	NPR	Tenebreus
Tenebrox	NOM	Tenebrox
a	PRE	a3|a_+T|CGIS
ce	PRO:invar	ce1|ce_S|C
conquist	VER	conquerre_+I
contes	NOM	conte1|conte2_+I|+I
de	PRE	de_+CIST
dist	VER	dire_+CMI
dit	VER	dire_+CMI
et	CON:coord	et_ST
fist	VER	faire|feire|fere_+CMI|M|M
fu	VER	estre1|estre_+I|CMI
grans	ADJ	grant_+I
il	PRO:pers	il_CIST
ioie	NOM	joie|jo�e1|jo�e2_*+IT|+Td|+Td
joie	NOM	joie|jo�e1|jo�e2_+IT|+Td|+Td
ke	PROCON	que1|que2|que3|que4|que2_S|S|S|S|T
l'	ADV	<nolem>
en	PRE	en1|en_+IST|CI
l'	DET:def	le_ST
onors	NOM	onor_*+IT
l'	DET:def	le_ST
ouneurs	NOM	ouneurs
la	ADV	l�_+IIdTd
le	PRO:pers	il_CIST
li	PRO:pers	ele|il_C|CIST
on	PRO:invar	on_CS
ou	PROCON	o|o�_C|Td
que	PROCON	que2|que3|que_T|S|C