Acaron	NOM	Acaron
Escalon	NPR	Escalon
Grans	NPR	Grans
Grant	NPR	Grant
Lanceloht	NPR	Lanceloht
Lancelot	VER	Lancelot
Or	NPR	Or
Tenebreus	NPR	Tenebreus
Tenebrox	NOM	Tenebrox
a	PRE	a
ce	PRO:invar	ce
conquist	VER	conquerre
contes	NOM	conte
de	PRE	de
dist	VER	dire
dit	VER	dire
et	CON:coord	et
fist	VER	faire|feire|fere
fu	VER	estre
grans	ADJ	grant
il	PRO:pers	il
ioie	NOM	joie|joöe
joie	NOM	joie|joöe
ke	PROCON	que
l'	ADV	UNKNOWN
en	PRE	en
l'	DET:def	le
onors	NOM	onor
l'	DET:def	le
ouneurs	NOM	ouneurs
la	ADV	lö
le	PRO:pers	il
li	PRO:pers	ele|il
on	PRO:invar	on
ou	PROCON	o|oö
que	PROCON	que