a	VER	avoir_+CMI
achever	VER	achever_+MIT
ait	VER	aidier|avoir_+MIdMd|+CIM
autres	ADJ	autre_CI
aventures	NOM	aventure_+I
car	CON:coord	car_ST
chevalerie	NOM	chevalerie_+IT
chevalier	NOM	chevalier_+IT
dex	NOM	dieu_+I
diex	NOM	dieu_*+CIT
en	PRO:clit	en2|en_S|C
la	PRO:pers	ele|il_C|IST
lairoiz	VER	laissier_+Z
lerroiz	VER	lerroiz
les	DET:def	le_CST
lesroiz	NOM	lesroiz
mis	VER	manoir|metre|mettre_M|CIM|M
mise	VER	metre|mettre_IM|M
ou	PROCON	o|o�_C|Td
par	PRE	par_CIS
proece	NOM	pröece_+IdTd
proesce	NOM	pröece_+I
quar	CON:coord	car_S
que	PROCON	que2|que3|que_T|S|C
vos	PRO:pers	ous2|vos1|vos_T|S|I
