a	VER	avoir
achever	VER	achever
ait	VER	aidier
autres	ADJ	autre
aventures	NOM	aventure
car	CON:coord	car
chevalerie	NOM	chevalerie
chevalier	NOM	chevalier
dex	NOM	dieu
diex	NOM	dieu
en	PRO:clit	en
la	PRO:pers	ele
lairoiz	VER	laissier
lerroiz	VER	lerroiz
les	DET:def	le
lesroiz	NOM	lesroiz
mis	VER	manoir
mise	VER	metre
ou	PROCON	o
par	PRE	par
proece	NOM	pröece
proesce	NOM	pröece
quar	CON:coord	car
que	PROCON	que
vos	PRO:pers	ous