aler	VER	aler|foraler_+MIT|+T
bel	ADJ	bel1|bel_+T|I
bial	ADJ	bel_Z
biau	ADJ	bel_I
ce	PRO:invar	ce1|ce_S|C
cist	VER	<nolem>
come	CON:subord	come1_T
devez	VER	devoir_+MI
devries	VER	devries
devriez	VER	devoir_+IId
est	VER	ester|estre1_+M|+I
laissier	VER	laissier_+IMT
lessier	VER	laissier_+IT
mie	ADV	mie_C
ne	PRO:clit	en2|ne_S|C
nel	PROCON	il|ne1_Z|Z
pas	NOM	pas|past2_+IT|+T
si	PROCON	si_C
vallet	NOM	vaslet_+IT
vaslet	NOM	vaslet_+IT
vos	PRO:pers	ous2|vos1|vos_T|S|I