aler	VER	aler
bel	ADJ	bel
bial	ADJ	bel
biau	ADJ	bel
ce	PRO:invar	ce
cist	VER	UNKNOWN
come	CON:subord	come
devez	VER	devoir
devries	VER	devries
devriez	VER	devoir
est	VER	ester
laissier	VER	laissier
lessier	VER	laissier
mie	ADV	mie
ne	PRO:clit	en
nel	PROCON	il
pas	NOM	pas
si	PROCON	si
vallet	NOM	vaslet
vaslet	NOM	vaslet
vos	PRO:pers	ous