Adonc	ADV	adonc_+GIT
Lors	VER	Lors
a	PRE	a3|a_+T|CGIS
an	NOM	an_+CIT
apelee	VER	apeler_+MI
armes	NOM	ame|arme_+C|+I
avoit	VER	avoiier|avoir_+MI|+MI
chevalier	NOM	chevalier_+IT
coment	ADV	coment1|coment_+T|I
comment	ADV	coment1|coment_*+T|I
conte	VER	conter_+I
dame	NOM	dam|dame|dan2_+T|+CIT|+T
de	PRE	de_+CIST
del	PREDET:de	de+le_S
des	PREDET:de	de+le|le_S|C
du	PREDET:de	de+le|le_S|C
ele	PRO:pers	ele|il_C|IST
elle	PRO:pers	ele|il_C|S
en	PRO:clit	en2|en_S|C
este	VER	estre_CM
estoit	VER	ester|estre1_+IM|+I
et	CON:coord	et_ST
feist	VER	faire|feire_+MIdMd|Md
il	PRO:pers	il_CIST
l	PRO:pers	il_CS
la	DET:def	le_CST
lac	NOM	lac_+IT
le	PRO:pers	il_CIST
li	PRO:pers	ele|il_C|CIST
lo	DET:def	le_ST
meismes	ADJ	meisme|m�isme_C|IId
merveille	NOM	merveille_+IT
mervelle	NOM	merveille_+Z
mervoille	VER	merveillier_+IM
mout	ADV	mout_I
mult	ADV	mout_I
ne	PROCON	ni_C
non	ADV	ne1_+Z
pria	VER	priier_+I
qu	PROCON	que1|que2|que3|que4|que_S|S|S|S|C
que	PROCON	que2|que3|que_T|S|C
reine	NOM	regne|rein|r�ine1_+T|+T|+IdTTd
requis	VER	requerre_+CI
robes	NOM	robe_+I
roine	NOM	r�ine1|r�ine2_+IdTTd|+Td
rois	NOM	roi2|rois1|rois2|roix_+I|+T|+T|+T
s	PROCON	se_C
se	PROCON	se_C
ses	DET:poss	son4|son_S|C
soes	ADJ	suen_I
tarde	VER	tarder|targier_+IM|M
trop	ADV	trop_+IT
vaslet	NOM	vaslet_+IT
voie	NOM	voie_+CIT