Adonc	ADV	adonc
Lors	VER	Lors
a	PRE	a
an	NOM	an
apelee	VER	apeler
armes	NOM	ame
avoit	VER	avoiier
chevalier	NOM	chevalier
coment	ADV	coment
comment	ADV	coment
conte	VER	conter
dame	NOM	dam
de	PRE	de
del	PREDET:de	de+le
des	PREDET:de	de+le
du	PREDET:de	de+le
ele	PRO:pers	ele
elle	PRO:pers	ele
en	PRO:clit	en
este	VER	estre
estoit	VER	ester
et	CON:coord	et
feist	VER	faire
il	PRO:pers	il
l	PRO:pers	il
la	DET:def	le
lac	NOM	lac
le	PRO:pers	il
li	PRO:pers	ele
lo	DET:def	le
meismes	ADJ	meisme
merveille	NOM	merveille
mervelle	NOM	merveille
mervoille	VER	merveillier
mout	ADV	mout
mult	ADV	mout
ne	PROCON	ni
non	ADV	ne
pria	VER	priier
qu	PROCON	que
que	PROCON	que
reine	NOM	regne
requis	VER	requerre
robes	NOM	robe
roine	NOM	rï¿½ine
rois	NOM	roi
s	PROCON	se
se	PROCON	se
ses	DET:poss	son
soes	ADJ	suen
tarde	VER	tarder
trop	ADV	trop
vaslet	NOM	vaslet
voie	NOM	voie